Julio César (Julius Caesar) es una película estadounidense de 1953 basada en la obra de teatro homónima escrita por William Shakespeare. 
La película fue dirigida por Joseph L. Mankiewicz y contó con Marlon Brando en el papel de Marco Antonio, James Mason en el de Bruto, John Gielgud en el de Casio y Louis Calhern en el de Julio César.


== Reparto ==
Un adivino: Richard Hale.
Artemidoro:[n 1]​ Morgan Farley.
Bruto: James Mason.
Calpurnia: Greer Garson.
Casca: Edmond O'Brien.
Casio: John Gielgud.
Cicerón: Alan Napier.
Cinna: William Cottrell.
Una ciudadana romana: Jo Gilbert.
Un ciudadano romano: John Doucette.
Otro ciudadano romano: Lawrence Dobkin.
Claudio: Preston Hanson.
Clito: Joseph Waring (como Joe Waring).
Dardanio: Stephen Roberts.
Décimo Bruto: John Hoyt.
Estrato: Edmund Purdom.
Flavo[n 2]​: Michael Pate.
Julio César: Louis Calhern.
Lépido: Douglass Dumbrille.
Ligario: Ian Wolfe.
Lucilio: Rhys Williams.
Lucio:[n 3]​ John Hardy.
Marco Antonio: Marlon Brando.
Marulo (Cayo Epidio Marulo): George Macready.
Mesala: Dayton Lummis.
Octavio César: Douglass Watson.
Un oficial de Octavio: Michael Tolan.
Píndaro: Michael Ansara.
Popilio Lena: Victor Perry.
Porcia: Deborah Kerr.
Publio: Lumsden Hare.
Un sirviente de Julio César: Chet Stratton.
Un sirviente de Marco Antonio: William Phipps.
Ticinio: John Parrish.
Tilio Cimbro (Lucio Tilio Cimbro): Tom Powers.
Trebonio: Jack Raine.
Varrón: John Lupton.


== Candidaturas y premios ==
Un Oscar de la academia en la categoría de mejor dirección artística. Además, Marlon Brando fue candidato al premio al mejor actor; también hubo candidatura a los premios a la mejor fotografía en blanco y negro, a la mejor música original y a la mejor película.Dos BAFTA británicos: al mejor actor británico (John Gielgud) y al mejor actor extranjero (Marlon Brando).


== Notas ==


== Enlaces externos ==

Julio César en Internet Movie Database (en inglés).Música de la película, de Miklós Rózsa.
Sobre la música, en el sitio Score Magacine; en español.
Ouverture y Prelude (Obertura y Preludio).
Suite de la música.