The Big Short (bra: A Grande Aposta; prt: A Queda de Wall Street) é um filme estadunidense de 2015, do gênero comédia dramático-biográfica, dirigido por Adam McKay, com roteiro dele e de Charles Randolph baseado no livro homônimo de Michael Lewis.Estrelado por Christian Bale, Steve Carell, Ryan Gosling e Brad Pitt, o longa aborda a crise financeira de 2007-2008.


== Prêmios e indicações ==


== Elenco ==
Christian Bale - Michael Burry
Steve Carell - Mark Baum
Ryan Gosling - Jared Vennett
John Magaro - Charlie Geller
Finn Wittrock - Jamie Shipley
Brad Pitt - Ben Rickert
Hamish Linklater - Porter Collins
Rafe Spall - Danny Moses
Jeremy Strong - Vinny Daniel
Marisa Tomei - Cynthia Baum
Melissa Leo - Georgia Hale
Stanley Wong - Ted Jiang
Byron Mann - Wing Chau
Tracy Letts - Lawrence Fields
Karen Gillan - Evie
Max Greenfield
Margot Robbie - Ela mesma
Selena Gomez - Ela mesma
Richard Thaler - Ele mesmo
Anthony Bourdain - Ele mesmo


== Recepção ==
O filme foi, em geral, bem recebido pela crítica e público. No Metracritic, atingiu uma pontuação de 81/100, com base em 45 críticas. No Rotten Tomatoes, tem uma taxa de aprovação de 88% com base em 319 críticas.


== Ver também ==
Trabalho Interno
Crise de 2008
Too Big to Fail (filme)


== Referências ==